NO ./maps/images/NO.xpm
SO ./maps/images/SO.xpm
WE ./maps/images/WE.xpm
EA ./maps/images/EA.xpm
F 00,153,15
C 155,155,155
        1111111111111111111111111
        1000000000000000000000011
        1100000000000001111111111
        1000100000000001
111111110000000000000001
10000000000000000000000011111
11111111111111110000000000001
10000000000000010000000000001
10000111111111110000000000001
10100000000000000000000000001
1000000000000001111W100000001
1001111111000001   1100000011
10000011 1000001    100000001
11111111 1111111    111111111
