NO ./maps/images/dog.xpm
SO ./maps/images/pan.xpm
WE ./maps/images/bird.xpm
EA ./maps/images/cat.xpm

F 60,179,113
C 101,190,223

        111111111111111111111111111111
        10000000000000000000000011111111111111
        11000000000000000000000111111111111101
        10000000000000000000100000000000000001
1111111110000000000000000000000011111111111111
1E000000000000000001000000000111111111
10000000000000100111000000010000001 1  
10000000000000001000000001111110000111
10000001000000000000000000111111111111   1
100000101000001100000000010000111111
1000000000000000100101000000111111
1100000011010101111011110101111111
11111111011111110111111111111111
111111111111 111111111111111111111
11



