NO ./map_tester/images/NO.xpm
SO ./map_tester/images/SO.xpm
WE ./map_tester/images/WE.xpm
EA ./map_tester/images/EA.xpm
F 00,153,15
C 255,255,255

        111111111111111111111111111111
        100000000000000000000000111111
        11000000000000000000000111
        100000000000000000001011
1111111110000000000000000000000011111
10000000000000000001000000000111111111
10000000000000100111000000010000001111
10000000000000001000000001111110000111
10000001000000000000000000111111111111
1000001W10000000000000010000111111
1000000000000000100101000000111111
1100000011010101111011110101111111
11111111011111110111111111111111
111111111111111111111111111111111





